
NO ./map/texture/wall1.xpm


SO ./map/texture/wall_b1.xpm
WE ./map/texture/wall_s1.xpm

EA ./map/texture/wall_p1.xpm

F 220,100,0



    C 225,30,0

        1111111111111111111111111
        1000000000110000000000001
        1011000001110000000000001
        1001000000000000000000001
111111111011000001110000000000001
100000000011111111110111111111111
11110111111        1000010001
111101111          1010010001
1100000011         1000010001
100000000111111111110000D0001
1000000000000000000D010010001
11000001110101011111011110N0111
11110111 1110101 101111010001
11111111 1111111 111111111111