
NO ./map/texture/wall1.xpm


SO ./map/texture/wall_b1.xpm
WE ./map/texture/wall_s1.xpm

EA ./map/texture/wall_p1.xpm

F 0,76,253



    C 153,204,255

111111111
100010101
100010101
10001000111
100010000011
100011D11001
100000000001
100011110001
10001  10001
100011110001
100N000D001
111111111111