
NO ./texture/Leaves_Light.xpm


SO ./texture/Leaves_Medium.xpm
WE ./texture/Bricks5_Light.xpm

EA ./texture/Plank2_Dark.xpm

F 160,160,160



    C 153,204,255

111111111111111111111111111111111111
100000000000000000000000000000000011
100000000000000000000000000000000011
100010001111111111110000000000000011
100010000011       10000000000010001
100011D11001       10000000000010001
100000000001       10000000000010001
100011110001       10000000000010001
10001  10001       10000000000010001
100011110001111111111000000000001001
100S000D000D000000000000000000000001
111111111111111111111111111111111111