NO ./map/texture/Leaves_Light.xpm


SO ./map/texture/Leaves_Medium.xpm
WE ./map/texture/Bricks5_Light.xpm

EA ./map/texture/Plank2_Dark.xpm

F 160,160,160



    C 153,204,255

        1111111111111111111111111
        1000000000110000000000001
        1011000001110000000000001
        1001000000000000000000001
111111111111111111111111111111111
 
 
 
 
 
11111111111111111111111111111
10000000000000000001010010001
11000001110101011111011110N0111
11110111 1110101 101111010001
11111111 1111111 111111111111
