
NO ./map/texture/wall1.xpm


SO ./map/texture/wall_b1.xpm
WE ./map/texture/wall_s1.xpm

EA ./map/texture/wall_p1.xpm

F 220,100,0



    C 225,30,0

        1111111111111111111111111
        1000000000110000000000001
        1011000001110000000ZA0001
        1001000000000000000QV0001
111111111111111111111111111111111
101
101
101
101
101
11111111111111111111111111111
10000000000000000001010010001
11000001110101011111011110N0111
11110111 1110101 101111010001
11111111 1111111 111111111111
